1111111111
10P0E0C001
1111111111
