1111111111
1000000001
1111111111
10P0000001
1111111111
10000000E1
1111111111
