1111111111
10000C0001
1110111111
10P0000001
1111111111
10000000E1
1111111111
