1111111111
1E000C0001
1111111111
10P0000001
1111111111
10000000E1
1111111111
