1111111111
10P0000C01
10000E0000
1000000001
1111111111
