1111111111
10P0000C1
10000E0001
1000000001
1111111111
