1111111111
10P0000C01
01000E0001
1000000001
1111111111
