1110111111
10P0000C01
10000E0001
1000000001
1111111111
