1111111111
10000C0001
1111111111
1000000001
1111111111
10000000E1
1111111111
