1111111111
10000C0001
1111111111
10P0000P01
1111111111
10000000E1
1111111111
