1111111111
1P00000001
1111111101
1110000001
1000111111
1011110001
1000C00101
1111111101
1E00000001
1111111111
