1111111111
1010100001
1010101101
1010101001
1010101011
1P10C01E11
1010101001
1010101101
1000100001
1111111111
